/	django.views.generic.base.RedirectView
/admin/	django.contrib.admin.sites.index	admin:index
/admin/<app_label>/	django.contrib.admin.sites.app_index	admin:app_list
/admin/<url>	django.contrib.admin.sites.catch_all_view
/admin/auth/group/	django.contrib.admin.options.changelist_view	admin:auth_group_changelist
/admin/auth/group/<path:object_id>/	django.views.generic.base.RedirectView
/admin/auth/group/<path:object_id>/change/	django.contrib.admin.options.change_view	admin:auth_group_change
/admin/auth/group/<path:object_id>/delete/	django.contrib.admin.options.delete_view	admin:auth_group_delete
/admin/auth/group/<path:object_id>/history/	django.contrib.admin.options.history_view	admin:auth_group_history
/admin/auth/group/add/	django.contrib.admin.options.add_view	admin:auth_group_add
/admin/auth/user/	django.contrib.admin.options.changelist_view	admin:auth_user_changelist
/admin/auth/user/<id>/password/	django.contrib.auth.admin.user_change_password	admin:auth_user_password_change
/admin/auth/user/<path:object_id>/	django.views.generic.base.RedirectView
/admin/auth/user/<path:object_id>/change/	django.contrib.admin.options.change_view	admin:auth_user_change
/admin/auth/user/<path:object_id>/delete/	django.contrib.admin.options.delete_view	admin:auth_user_delete
/admin/auth/user/<path:object_id>/history/	django.contrib.admin.options.history_view	admin:auth_user_history
/admin/auth/user/add/	django.contrib.auth.admin.add_view	admin:auth_user_add
/admin/autocomplete/	django.contrib.admin.sites.autocomplete_view	admin:autocomplete
/admin/core/equipmentcategory/	django.contrib.admin.options.changelist_view	admin:core_equipmentcategory_changelist
/admin/core/equipmentcategory/<path:object_id>/	django.views.generic.base.RedirectView
/admin/core/equipmentcategory/<path:object_id>/change/	django.contrib.admin.options.change_view	admin:core_equipmentcategory_change
/admin/core/equipmentcategory/<path:object_id>/delete/	django.contrib.admin.options.delete_view	admin:core_equipmentcategory_delete
/admin/core/equipmentcategory/<path:object_id>/history/	django.contrib.admin.options.history_view	admin:core_equipmentcategory_history
/admin/core/equipmentcategory/add/	django.contrib.admin.options.add_view	admin:core_equipmentcategory_add
/admin/core/location/	django.contrib.admin.options.changelist_view	admin:core_location_changelist
/admin/core/location/<path:object_id>/	django.views.generic.base.RedirectView
/admin/core/location/<path:object_id>/change/	django.contrib.admin.options.change_view	admin:core_location_change
/admin/core/location/<path:object_id>/delete/	django.contrib.admin.options.delete_view	admin:core_location_delete
/admin/core/location/<path:object_id>/history/	django.contrib.admin.options.history_view	admin:core_location_history
/admin/core/location/add/	django.contrib.admin.options.add_view	admin:core_location_add
/admin/core/userprofile/	django.contrib.admin.options.changelist_view	admin:core_userprofile_changelist
/admin/core/userprofile/<path:object_id>/	django.views.generic.base.RedirectView
/admin/core/userprofile/<path:object_id>/change/	django.contrib.admin.options.change_view	admin:core_userprofile_change
/admin/core/userprofile/<path:object_id>/delete/	django.contrib.admin.options.delete_view	admin:core_userprofile_delete
/admin/core/userprofile/<path:object_id>/history/	django.contrib.admin.options.history_view	admin:core_userprofile_history
/admin/core/userprofile/add/	django.contrib.admin.options.add_view	admin:core_userprofile_add
/admin/django_celery_beat/clockedschedule/	django.contrib.admin.options.changelist_view	admin:django_celery_beat_clockedschedule_changelist
/admin/django_celery_beat/clockedschedule/<path:object_id>/	django.views.generic.base.RedirectView
/admin/django_celery_beat/clockedschedule/<path:object_id>/change/	django.contrib.admin.options.change_view	admin:django_celery_beat_clockedschedule_change
/admin/django_celery_beat/clockedschedule/<path:object_id>/delete/	django.contrib.admin.options.delete_view	admin:django_celery_beat_clockedschedule_delete
/admin/django_celery_beat/clockedschedule/<path:object_id>/history/	django.contrib.admin.options.history_view	admin:django_celery_beat_clockedschedule_history
/admin/django_celery_beat/clockedschedule/add/	django.contrib.admin.options.add_view	admin:django_celery_beat_clockedschedule_add
/admin/django_celery_beat/crontabschedule/	django.contrib.admin.options.changelist_view	admin:django_celery_beat_crontabschedule_changelist
/admin/django_celery_beat/crontabschedule/<path:object_id>/	django.views.generic.base.RedirectView
/admin/django_celery_beat/crontabschedule/<path:object_id>/change/	django.contrib.admin.options.change_view	admin:django_celery_beat_crontabschedule_change
/admin/django_celery_beat/crontabschedule/<path:object_id>/delete/	django.contrib.admin.options.delete_view	admin:django_celery_beat_crontabschedule_delete
/admin/django_celery_beat/crontabschedule/<path:object_id>/history/	django.contrib.admin.options.history_view	admin:django_celery_beat_crontabschedule_history
/admin/django_celery_beat/crontabschedule/add/	django.contrib.admin.options.add_view	admin:django_celery_beat_crontabschedule_add
/admin/django_celery_beat/intervalschedule/	django.contrib.admin.options.changelist_view	admin:django_celery_beat_intervalschedule_changelist
/admin/django_celery_beat/intervalschedule/<path:object_id>/	django.views.generic.base.RedirectView
/admin/django_celery_beat/intervalschedule/<path:object_id>/change/	django.contrib.admin.options.change_view	admin:django_celery_beat_intervalschedule_change
/admin/django_celery_beat/intervalschedule/<path:object_id>/delete/	django.contrib.admin.options.delete_view	admin:django_celery_beat_intervalschedule_delete
/admin/django_celery_beat/intervalschedule/<path:object_id>/history/	django.contrib.admin.options.history_view	admin:django_celery_beat_intervalschedule_history
/admin/django_celery_beat/intervalschedule/add/	django.contrib.admin.options.add_view	admin:django_celery_beat_intervalschedule_add
/admin/django_celery_beat/periodictask/	django_celery_beat.admin.changelist_view	admin:django_celery_beat_periodictask_changelist
/admin/django_celery_beat/periodictask/<path:object_id>/	django.views.generic.base.RedirectView
/admin/django_celery_beat/periodictask/<path:object_id>/change/	django.contrib.admin.options.change_view	admin:django_celery_beat_periodictask_change
/admin/django_celery_beat/periodictask/<path:object_id>/delete/	django.contrib.admin.options.delete_view	admin:django_celery_beat_periodictask_delete
/admin/django_celery_beat/periodictask/<path:object_id>/history/	django.contrib.admin.options.history_view	admin:django_celery_beat_periodictask_history
/admin/django_celery_beat/periodictask/add/	django.contrib.admin.options.add_view	admin:django_celery_beat_periodictask_add
/admin/django_celery_beat/solarschedule/	django.contrib.admin.options.changelist_view	admin:django_celery_beat_solarschedule_changelist
/admin/django_celery_beat/solarschedule/<path:object_id>/	django.views.generic.base.RedirectView
/admin/django_celery_beat/solarschedule/<path:object_id>/change/	django.contrib.admin.options.change_view	admin:django_celery_beat_solarschedule_change
/admin/django_celery_beat/solarschedule/<path:object_id>/delete/	django.contrib.admin.options.delete_view	admin:django_celery_beat_solarschedule_delete
/admin/django_celery_beat/solarschedule/<path:object_id>/history/	django.contrib.admin.options.history_view	admin:django_celery_beat_solarschedule_history
/admin/django_celery_beat/solarschedule/add/	django.contrib.admin.options.add_view	admin:django_celery_beat_solarschedule_add
/admin/equipment/equipment/	django.contrib.admin.options.changelist_view	admin:equipment_equipment_changelist
/admin/equipment/equipment/<path:object_id>/	django.views.generic.base.RedirectView
/admin/equipment/equipment/<path:object_id>/change/	django.contrib.admin.options.change_view	admin:equipment_equipment_change
/admin/equipment/equipment/<path:object_id>/delete/	django.contrib.admin.options.delete_view	admin:equipment_equipment_delete
/admin/equipment/equipment/<path:object_id>/history/	django.contrib.admin.options.history_view	admin:equipment_equipment_history
/admin/equipment/equipment/add/	django.contrib.admin.options.add_view	admin:equipment_equipment_add
/admin/equipment/equipmentcomponent/	django.contrib.admin.options.changelist_view	admin:equipment_equipmentcomponent_changelist
/admin/equipment/equipmentcomponent/<path:object_id>/	django.views.generic.base.RedirectView
/admin/equipment/equipmentcomponent/<path:object_id>/change/	django.contrib.admin.options.change_view	admin:equipment_equipmentcomponent_change
/admin/equipment/equipmentcomponent/<path:object_id>/delete/	django.contrib.admin.options.delete_view	admin:equipment_equipmentcomponent_delete
/admin/equipment/equipmentcomponent/<path:object_id>/history/	django.contrib.admin.options.history_view	admin:equipment_equipmentcomponent_history
/admin/equipment/equipmentcomponent/add/	django.contrib.admin.options.add_view	admin:equipment_equipmentcomponent_add
/admin/equipment/equipmentdocument/	django.contrib.admin.options.changelist_view	admin:equipment_equipmentdocument_changelist
/admin/equipment/equipmentdocument/<path:object_id>/	django.views.generic.base.RedirectView
/admin/equipment/equipmentdocument/<path:object_id>/change/	django.contrib.admin.options.change_view	admin:equipment_equipmentdocument_change
/admin/equipment/equipmentdocument/<path:object_id>/delete/	django.contrib.admin.options.delete_view	admin:equipment_equipmentdocument_delete
/admin/equipment/equipmentdocument/<path:object_id>/history/	django.contrib.admin.options.history_view	admin:equipment_equipmentdocument_history
/admin/equipment/equipmentdocument/add/	django.contrib.admin.options.add_view	admin:equipment_equipmentdocument_add
/admin/events/calendarevent/	django.contrib.admin.options.changelist_view	admin:events_calendarevent_changelist
/admin/events/calendarevent/<path:object_id>/	django.views.generic.base.RedirectView
/admin/events/calendarevent/<path:object_id>/change/	django.contrib.admin.options.change_view	admin:events_calendarevent_change
/admin/events/calendarevent/<path:object_id>/delete/	django.contrib.admin.options.delete_view	admin:events_calendarevent_delete
/admin/events/calendarevent/<path:object_id>/history/	django.contrib.admin.options.history_view	admin:events_calendarevent_history
/admin/events/calendarevent/add/	django.contrib.admin.options.add_view	admin:events_calendarevent_add
/admin/events/eventattachment/	django.contrib.admin.options.changelist_view	admin:events_eventattachment_changelist
/admin/events/eventattachment/<path:object_id>/	django.views.generic.base.RedirectView
/admin/events/eventattachment/<path:object_id>/change/	django.contrib.admin.options.change_view	admin:events_eventattachment_change
/admin/events/eventattachment/<path:object_id>/delete/	django.contrib.admin.options.delete_view	admin:events_eventattachment_delete
/admin/events/eventattachment/<path:object_id>/history/	django.contrib.admin.options.history_view	admin:events_eventattachment_history
/admin/events/eventattachment/add/	django.contrib.admin.options.add_view	admin:events_eventattachment_add
/admin/events/eventcomment/	django.contrib.admin.options.changelist_view	admin:events_eventcomment_changelist
/admin/events/eventcomment/<path:object_id>/	django.views.generic.base.RedirectView
/admin/events/eventcomment/<path:object_id>/change/	django.contrib.admin.options.change_view	admin:events_eventcomment_change
/admin/events/eventcomment/<path:object_id>/delete/	django.contrib.admin.options.delete_view	admin:events_eventcomment_delete
/admin/events/eventcomment/<path:object_id>/history/	django.contrib.admin.options.history_view	admin:events_eventcomment_history
/admin/events/eventcomment/add/	django.contrib.admin.options.add_view	admin:events_eventcomment_add
/admin/events/eventreminder/	django.contrib.admin.options.changelist_view	admin:events_eventreminder_changelist
/admin/events/eventreminder/<path:object_id>/	django.views.generic.base.RedirectView
/admin/events/eventreminder/<path:object_id>/change/	django.contrib.admin.options.change_view	admin:events_eventreminder_change
/admin/events/eventreminder/<path:object_id>/delete/	django.contrib.admin.options.delete_view	admin:events_eventreminder_delete
/admin/events/eventreminder/<path:object_id>/history/	django.contrib.admin.options.history_view	admin:events_eventreminder_history
/admin/events/eventreminder/add/	django.contrib.admin.options.add_view	admin:events_eventreminder_add
/admin/jsi18n/	django.contrib.admin.sites.i18n_javascript	admin:jsi18n
/admin/login/	django.contrib.admin.sites.login	admin:login
/admin/logout/	django.contrib.admin.sites.logout	admin:logout
/admin/maintenance/activitytypecategory/	django.contrib.admin.options.changelist_view	admin:maintenance_activitytypecategory_changelist
/admin/maintenance/activitytypecategory/<path:object_id>/	django.views.generic.base.RedirectView
/admin/maintenance/activitytypecategory/<path:object_id>/change/	django.contrib.admin.options.change_view	admin:maintenance_activitytypecategory_change
/admin/maintenance/activitytypecategory/<path:object_id>/delete/	django.contrib.admin.options.delete_view	admin:maintenance_activitytypecategory_delete
/admin/maintenance/activitytypecategory/<path:object_id>/history/	django.contrib.admin.options.history_view	admin:maintenance_activitytypecategory_history
/admin/maintenance/activitytypecategory/add/	django.contrib.admin.options.add_view	admin:maintenance_activitytypecategory_add
/admin/maintenance/activitytypetemplate/	django.contrib.admin.options.changelist_view	admin:maintenance_activitytypetemplate_changelist
/admin/maintenance/activitytypetemplate/<path:object_id>/	django.views.generic.base.RedirectView
/admin/maintenance/activitytypetemplate/<path:object_id>/change/	django.contrib.admin.options.change_view	admin:maintenance_activitytypetemplate_change
/admin/maintenance/activitytypetemplate/<path:object_id>/delete/	django.contrib.admin.options.delete_view	admin:maintenance_activitytypetemplate_delete
/admin/maintenance/activitytypetemplate/<path:object_id>/history/	django.contrib.admin.options.history_view	admin:maintenance_activitytypetemplate_history
/admin/maintenance/activitytypetemplate/add/	django.contrib.admin.options.add_view	admin:maintenance_activitytypetemplate_add
/admin/maintenance/maintenanceactivity/	django.contrib.admin.options.changelist_view	admin:maintenance_maintenanceactivity_changelist
/admin/maintenance/maintenanceactivity/<path:object_id>/	django.views.generic.base.RedirectView
/admin/maintenance/maintenanceactivity/<path:object_id>/change/	django.contrib.admin.options.change_view	admin:maintenance_maintenanceactivity_change
/admin/maintenance/maintenanceactivity/<path:object_id>/delete/	django.contrib.admin.options.delete_view	admin:maintenance_maintenanceactivity_delete
/admin/maintenance/maintenanceactivity/<path:object_id>/history/	django.contrib.admin.options.history_view	admin:maintenance_maintenanceactivity_history
/admin/maintenance/maintenanceactivity/add/	django.contrib.admin.options.add_view	admin:maintenance_maintenanceactivity_add
/admin/maintenance/maintenanceactivitytype/	django.contrib.admin.options.changelist_view	admin:maintenance_maintenanceactivitytype_changelist
/admin/maintenance/maintenanceactivitytype/<path:object_id>/	django.views.generic.base.RedirectView
/admin/maintenance/maintenanceactivitytype/<path:object_id>/change/	django.contrib.admin.options.change_view	admin:maintenance_maintenanceactivitytype_change
/admin/maintenance/maintenanceactivitytype/<path:object_id>/delete/	django.contrib.admin.options.delete_view	admin:maintenance_maintenanceactivitytype_delete
/admin/maintenance/maintenanceactivitytype/<path:object_id>/history/	django.contrib.admin.options.history_view	admin:maintenance_maintenanceactivitytype_history
/admin/maintenance/maintenanceactivitytype/add/	django.contrib.admin.options.add_view	admin:maintenance_maintenanceactivitytype_add
/admin/maintenance/maintenancechecklist/	django.contrib.admin.options.changelist_view	admin:maintenance_maintenancechecklist_changelist
/admin/maintenance/maintenancechecklist/<path:object_id>/	django.views.generic.base.RedirectView
/admin/maintenance/maintenancechecklist/<path:object_id>/change/	django.contrib.admin.options.change_view	admin:maintenance_maintenancechecklist_change
/admin/maintenance/maintenancechecklist/<path:object_id>/delete/	django.contrib.admin.options.delete_view	admin:maintenance_maintenancechecklist_delete
/admin/maintenance/maintenancechecklist/<path:object_id>/history/	django.contrib.admin.options.history_view	admin:maintenance_maintenancechecklist_history
/admin/maintenance/maintenancechecklist/add/	django.contrib.admin.options.add_view	admin:maintenance_maintenancechecklist_add
/admin/maintenance/maintenancereport/	django.contrib.admin.options.changelist_view	admin:maintenance_maintenancereport_changelist
/admin/maintenance/maintenancereport/<path:object_id>/	django.views.generic.base.RedirectView
/admin/maintenance/maintenancereport/<path:object_id>/change/	django.contrib.admin.options.change_view	admin:maintenance_maintenancereport_change
/admin/maintenance/maintenancereport/<path:object_id>/delete/	django.contrib.admin.options.delete_view	admin:maintenance_maintenancereport_delete
/admin/maintenance/maintenancereport/<path:object_id>/history/	django.contrib.admin.options.history_view	admin:maintenance_maintenancereport_history
/admin/maintenance/maintenancereport/add/	django.contrib.admin.options.add_view	admin:maintenance_maintenancereport_add
/admin/maintenance/maintenanceschedule/	django.contrib.admin.options.changelist_view	admin:maintenance_maintenanceschedule_changelist
/admin/maintenance/maintenanceschedule/<path:object_id>/	django.views.generic.base.RedirectView
/admin/maintenance/maintenanceschedule/<path:object_id>/change/	django.contrib.admin.options.change_view	admin:maintenance_maintenanceschedule_change
/admin/maintenance/maintenanceschedule/<path:object_id>/delete/	django.contrib.admin.options.delete_view	admin:maintenance_maintenanceschedule_delete
/admin/maintenance/maintenanceschedule/<path:object_id>/history/	django.contrib.admin.options.history_view	admin:maintenance_maintenanceschedule_history
/admin/maintenance/maintenanceschedule/add/	django.contrib.admin.options.add_view	admin:maintenance_maintenanceschedule_add
/admin/password_change/	django.contrib.admin.sites.password_change	admin:password_change
/admin/password_change/done/	django.contrib.admin.sites.password_change_done	admin:password_change_done
/admin/r/<int:content_type_id>/<path:object_id>/	django.contrib.contenttypes.views.shortcut	admin:view_on_site
/auth/login/	django.contrib.auth.views.LoginView	login
/auth/logout/	django.contrib.auth.views.LogoutView	logout
/auth/password_change/	django.contrib.auth.views.PasswordChangeView	password_change
/auth/password_change/done/	django.contrib.auth.views.PasswordChangeDoneView	password_change_done
/auth/password_reset/	django.contrib.auth.views.PasswordResetView	password_reset
/auth/password_reset/done/	django.contrib.auth.views.PasswordResetDoneView	password_reset_done
/auth/reset/<uidb64>/<token>/	django.contrib.auth.views.PasswordResetConfirmView	password_reset_confirm
/auth/reset/done/	django.contrib.auth.views.PasswordResetCompleteView	password_reset_complete
/core/	core.views.dashboard	core:dashboard
/core/api-explorer/	core.views.api_explorer	core:api_explorer
/core/api/endpoint-metrics/	core.views.endpoint_metrics_api	core:endpoint_metrics_api
/core/api/equipment-items/	core.views.equipment_items_api	core:equipment_items_api
/core/api/locations/	core.views.locations_api	core:locations_api
/core/api/locations/<int:location_id>/	core.views.location_detail_api	core:location_detail_api
/core/api/locations/bulk-edit/	core.views.bulk_edit_locations	core:bulk_edit_locations
/core/api/playwright-debug/	core.views.playwright_debug_api	core:playwright_debug_api
/core/api/playwright/natural-language/	core.views.run_natural_language_test_api	core:run_natural_language_test_api
/core/api/playwright/rbac-suite/	core.views.run_rbac_test_suite_api	core:run_rbac_test_suite_api
/core/api/playwright/results/	core.views.get_test_results_api	core:get_test_results_api
/core/api/playwright/scenarios/	core.views.run_test_scenario_api	core:run_test_scenario_api
/core/api/playwright/screenshots/	core.views.get_test_screenshots_api	core:get_test_screenshots_api
/core/api/roles/	core.views.roles_api	core:roles_api
/core/api/roles/<int:role_id>/	core.views.role_detail_api	core:role_detail_api
/core/api/test-health/	core.views.test_health	core:test_health
/core/api/toggle-monitoring/	core.views.toggle_monitoring	core:toggle_monitoring
/core/api/users/	core.views.users_api	core:users_api
/core/categories/<int:category_id>/delete/	core.views.delete_equipment_category	core:delete_equipment_category
/core/categories/<int:category_id>/edit/	core.views.edit_equipment_category	core:edit_equipment_category
/core/categories/add/	core.views.add_equipment_category	core:add_equipment_category
/core/customers/<int:customer_id>/delete/	core.views.delete_customer	core:delete_customer
/core/customers/<int:customer_id>/edit/	core.views.edit_customer	core:edit_customer
/core/customers/add/	core.views.add_customer	core:add_customer
/core/dashboard/	core.views.dashboard	core:dashboard
/core/debug/	core.views.debug	core:debug
/core/health	core.views.health_check	core:health_check_no_slash
/core/health-check/	core.views.health_check_api	core:health_check_api
/core/health-check/run/	core.views.run_health_check	core:run_health_check
/core/health/	core.views.health_check	core:health_check
/core/health/clear_logs/	core.views.clear_health_logs	core:clear_health_logs
/core/health/simple	core.views.simple_health_check	core:simple_health_check_no_slash
/core/health/simple/	core.views.simple_health_check	core:simple_health_check
/core/locations/<int:location_id>/delete/	core.views.delete_location	core:delete_location
/core/locations/<int:location_id>/edit/	core.views.edit_location	core:edit_location
/core/locations/add/	core.views.add_location	core:add_location
/core/locations/export/csv/	core.views.export_locations_csv	core:export_locations_csv
/core/locations/generate-pods/	core.views.generate_pods	core:generate_pods
/core/locations/import/csv/	core.views.import_locations_csv	core:import_locations_csv
/core/map/	core.views.map_view	core:map_view
/core/monitoring/	core.views.monitoring_dashboard	core:monitoring_dashboard
/core/playwright-slideshow/	core.views.playwright_slideshow	core:playwright_slideshow
/core/profile/	core.views.profile	core:profile
/core/settings/	core.views.settings	core:settings
/core/settings/clear-database/	core.views.clear_database	core:clear_database
/core/settings/customers/	core.views.customers_settings	core:customers_settings
/core/settings/equipment-categories/	core.views.equipment_categories_settings	core:equipment_categories_settings
/core/settings/equipment-items/	core.views.equipment_items_settings	core:equipment_items_settings
/core/settings/health/	core.views.system_health	core:system_health
/core/settings/locations/	core.views.locations_settings	core:locations_settings
/core/settings/locations/bulk/	core.views.bulk_locations_view	core:bulk_locations
/core/settings/populate-demo-data/	core.views.populate_demo_data	core:populate_demo_data
/core/settings/roles-permissions/	core.views.roles_permissions_management	core:roles_permissions_management
/core/settings/users/	core.views.user_management	core:user_management
/core/sites/export/csv/	core.views.export_sites_csv	core:export_sites_csv
/core/sites/import/csv/	core.views.import_sites_csv	core:import_sites_csv
/equipment/	equipment.views.equipment_list	equipment:equipment_list
/equipment/<int:equipment_id>/	equipment.views.equipment_detail	equipment:equipment_detail
/equipment/<int:equipment_id>/analyze-reports/	equipment.views.analyze_reports	equipment:analyze_reports
/equipment/<int:equipment_id>/components/	equipment.views.equipment_components	equipment:equipment_components
/equipment/<int:equipment_id>/components/add/	equipment.views.add_component	equipment:add_component
/equipment/<int:equipment_id>/delete/	equipment.views.delete_equipment	equipment:delete_equipment
/equipment/<int:equipment_id>/documents/	equipment.views.equipment_documents	equipment:equipment_documents
/equipment/<int:equipment_id>/documents/add/	equipment.views.add_document	equipment:add_document
/equipment/<int:equipment_id>/edit/	equipment.views.edit_equipment	equipment:edit_equipment
/equipment/<int:equipment_id>/scan-reports/	equipment.views.scan_reports	equipment:scan_reports
/equipment/add/	equipment.views.add_equipment	equipment:add_equipment
/equipment/api/data/	equipment.views.get_equipment_data	equipment:get_equipment_data
/equipment/api/search/	equipment.views.search_equipment	equipment:search_equipment
/equipment/export/csv/	equipment.views.export_equipment_csv	equipment:export_equipment_csv
/equipment/import/csv/	equipment.views.import_equipment_csv	equipment:import_equipment_csv
/equipment/locations/export/csv/	equipment.views.export_locations_csv	equipment:export_locations_csv
/equipment/locations/import/csv/	equipment.views.import_locations_csv	equipment:import_locations_csv
/equipment/manage/	equipment.views.manage_equipment	equipment:manage_equipment
/events/	events.views.calendar_view	events:calendar_view
/events/api/events/	events.views.fetch_events	events:fetch_events
/events/api/events/<int:event_id>/	events.views.get_event	events:get_event
/events/api/events/<int:event_id>/update/	events.views.update_event_ajax	events:update_event_ajax
/events/api/events/create/	events.views.create_event_ajax	events:create_event_ajax
/events/api/form-data/	events.views.get_form_data	events:get_form_data
/events/api/health/	events.views.test_application_health	events:test_application_health
/events/api/test-events/	events.views.test_events_api	events:test_events_api
/events/api/unified/	events.views.fetch_unified_events	events:fetch_unified_events
/events/calendar/	events.views.calendar_view	events:calendar_view
/events/equipment/<int:equipment_id>/events/	events.views.equipment_events	events:equipment_events
/events/events/	events.views.event_list	events:event_list
/events/events/<int:event_id>/	events.views.event_detail	events:event_detail
/events/events/<int:event_id>/complete/	events.views.complete_event	events:complete_event
/events/events/<int:event_id>/edit/	events.views.edit_event	events:edit_event
/events/events/add/	events.views.add_event	events:add_event
/events/ical/	events.views.generate_ical_feed	events:ical_feed
/events/settings/	events.views.calendar_settings	events:calendar_settings
/events/webhook/google/	events.views.google_calendar_webhook	events:google_calendar_webhook
/maintenance/	maintenance.views.maintenance_list	maintenance:maintenance_list
/maintenance/activities/	maintenance.views.activity_list	maintenance:activity_list
/maintenance/activities/<int:activity_id>/	maintenance.views.activity_detail	maintenance:activity_detail
/maintenance/activities/<int:activity_id>/complete/	maintenance.views.complete_activity	maintenance:complete_activity
/maintenance/activities/<int:activity_id>/delete/	maintenance.views.delete_activity	maintenance:delete_activity
/maintenance/activities/<int:activity_id>/edit/	maintenance.views.edit_activity	maintenance:edit_activity
/maintenance/activities/add/	maintenance.views.add_activity	maintenance:add_activity
/maintenance/activities/export/csv/	maintenance.views.export_maintenance_csv	maintenance:export_maintenance_csv
/maintenance/activities/import/csv/	maintenance.views.import_maintenance_csv	maintenance:import_maintenance_csv
/maintenance/activity-type-categories/	maintenance.views.activity_type_categories	maintenance:activity_type_categories
/maintenance/activity-type-categories/<int:category_id>/edit/	maintenance.views.edit_activity_type_category	maintenance:edit_activity_type_category
/maintenance/activity-type-categories/add/	maintenance.views.add_activity_type_category	maintenance:add_activity_type_category
/maintenance/activity-type-templates/	maintenance.views.activity_type_templates	maintenance:activity_type_templates
/maintenance/activity-type-templates/<int:template_id>/edit/	maintenance.views.edit_activity_type_template	maintenance:edit_activity_type_template
/maintenance/activity-type-templates/add/	maintenance.views.add_activity_type_template	maintenance:add_activity_type_template
/maintenance/activity-types/	maintenance.views.activity_type_list	maintenance:activity_type_list
/maintenance/activity-types/<int:activity_type_id>/edit/	maintenance.views.edit_activity_type	maintenance:edit_activity_type
/maintenance/activity-types/add/	maintenance.views.add_activity_type	maintenance:add_activity_type
/maintenance/activity-types/export/csv/	maintenance.views.export_activity_types_csv	maintenance:export_activity_types_csv
/maintenance/activity-types/import/csv/	maintenance.views.import_activity_types_csv	maintenance:import_activity_types_csv
/maintenance/ajax/create-activity-type-from-template/	maintenance.views.create_activity_type_from_template	maintenance:create_activity_type_from_template
/maintenance/ajax/get-activity-type-suggestions/	maintenance.views.get_activity_type_suggestions	maintenance:get_activity_type_suggestions
/maintenance/ajax/get-activity-type-templates/	maintenance.views.get_activity_type_templates	maintenance:get_activity_type_templates
/maintenance/ajax/get-template-details/<int:template_id>/	maintenance.views.get_template_details	maintenance:get_template_details
/maintenance/api/activities/	maintenance.views.get_activities_data	maintenance:get_activities_data
/maintenance/api/activity/<int:activity_id>/	maintenance.views.get_activity_details	maintenance:get_activity_details
/maintenance/api/fetch-activities/	maintenance.views.fetch_activities	maintenance:fetch_activities
/maintenance/api/generate-activities/	maintenance.views.generate_maintenance_activities	maintenance:generate_activities
/maintenance/api/reports/equipment/<int:equipment_id>/	maintenance.views.get_reports_for_equipment	maintenance:get_reports_for_equipment
/maintenance/enhanced-activity-types/	maintenance.views.enhanced_activity_type_list	maintenance:enhanced_activity_type_list
/maintenance/enhanced-activity-types/<int:activity_type_id>/edit/	maintenance.views.enhanced_edit_activity_type	maintenance:enhanced_edit_activity_type
/maintenance/enhanced-activity-types/add/	maintenance.views.enhanced_add_activity_type	maintenance:enhanced_add_activity_type
/maintenance/generate-activities/	maintenance.views.generate_maintenance_activities	maintenance:generate_maintenance_activities
/maintenance/generate-scheduled-activities/	maintenance.views.generate_scheduled_activities	maintenance:generate_scheduled_activities
/maintenance/overdue/	maintenance.views.overdue_maintenance	maintenance:overdue_maintenance
/maintenance/reports/	maintenance.views.maintenance_reports	maintenance:maintenance_reports
/maintenance/reports/<int:report_id>/	maintenance.views.report_detail	maintenance:report_detail
/maintenance/reports/<int:report_id>/analyze/	maintenance.views.analyze_report	maintenance:analyze_report
/maintenance/reports/list/	maintenance.views.report_list	maintenance:report_list
/maintenance/reports/upload/	maintenance.views.upload_report	maintenance:upload_report
/maintenance/schedules/	maintenance.views.schedule_list	maintenance:schedule_list
/maintenance/schedules/<int:schedule_id>/	maintenance.views.schedule_detail	maintenance:schedule_detail
/maintenance/schedules/<int:schedule_id>/delete/	maintenance.views.delete_schedule	maintenance:delete_schedule
/maintenance/schedules/<int:schedule_id>/edit/	maintenance.views.edit_schedule	maintenance:edit_schedule
/maintenance/schedules/add/	maintenance.views.add_schedule	maintenance:add_schedule
/maintenance/schedules/export/csv/	maintenance.views.export_maintenance_schedules_csv	maintenance:export_maintenance_schedules_csv
/maintenance/schedules/generate/	maintenance.views.generate_scheduled_activities	maintenance:generate_scheduled_activities
/media/<path>	django.views.static.serve
/static/<path>	django.views.static.serve
